S . . X . . .
. X . X . X .
. . . . . . .
. X X X . X .
. . . . . . .
. X . X X . .
. . . . . . G